3 5 963 46 3523 3542 2569 
1 5 1309 2225 2114 2397 4205 
1 4 4205 4235 1211 4299 
1 5 4230 4258 4263 4279 4300 
1 3 4300 1813 2029 
5 2 4658 6262 
5 7 6262 6261 6268 6269 4644 6474 2217 
5 5 4652 6268 6269 1180 2179 
5 3 6269 4636 2217 
5 4 4639 6274 2217 6474 
5 4 4639 6267 4652 4644 
5 3 4636 4625 4634 
5 2 6269 4643 
1 3 2179 6260 6259 
5 2 6259 1861 
1 3 4625 600 605 
1 4 605 185 2594 192 
1 3 192 8 1215 
1 5 1215 817 4545 4549 761 
5 2 761 815 
1 3 4605 182 4589 
1 3 2344 2531 4605 
1 4 2344 4570 609 2268 
1 2 2268 4511 
1 3 4624 4612 4589 
5 4 4619 1082 597 4624 
5 3 4631 1082 4619 
5 3 4627 4616 4619 
5 3 1024 4633 4627 
5 4 1024 4647 4649 4658 
5 2 4619 4609 
5 3 4609 4606 2451 
1 4 2047 872 850 4593 
1 4 2548 4622 31 4593 
1 4 2548 1743 4603 4595 
1 9 4595 4603 2251 2548 4622 363 2167 1800 1581 
1 4 4617 4615 4600 1581 
1 3 1581 2216 1038 
1 3 1038 6256 4601 
1 4 4565 4581 6256 4601 
1 3 4608 1185 4601 
1 4 4608 1508 4594 605 
1 4 4594 681 4576 409 
1 5 2161 2044 4731 4720 98 
3 6 1841 4792 4816 2331 248 2434 
3 6 1841 4780 1477 4770 4777 4782 
3 4 2434 702 4829 2444 
3 2 4847 2444 
3 10 2444 2663 4824 4814 4804 2398 4793 2194 1925 4794 
3 4 4816 1824 4827 4840 
3 4 2434 4772 1118 4744 
1 6 4624 4611 294 4573 761 815 
1 6 4605 182 4572 565 4527 815 
1 5 6271 4612 294 2622 1215 
1 6 4594 2004 765 4546 4539 1371 
1 6 1371 1292 1681 4493 301 2258 
5 16 1215 194 1417 642 328 847 708 214 4438 2544 1936 4420 2706 4438 4422 1936 
1 4 2544 2706 516 2258 
1 15 2544 2706 4440 63 1335 4437 231 692 1733 4416 224 286 1389 4436 1828 
1 3 4484 1004 121 
1 14 815 444 4482 121 792 2240 1253 12 212 2717 190 4339 6273 4365 
1 5 4365 6273 553 4315 768 
1 3 768 4290 1398 
1 9 2240 1253 4385 2443 1653 2146 680 75 1717 
4 9 1717 4209 4160 330 941 2103 1236 3951 1844 
4 52 1398 4270 4266 4244 820 4219 1366 4188 1793 4145 6282 6279 1222 4009 3987 3959 2687 3894 3885 275 3875 957 3857 3795 2352 770 2390 1255 1475 1240 159 667 3907 2682 181 39 4030 2108 4090 1457 4147 4134 110 4177 4212 1826 4227 488 1869 460 164 241 
1 5 1844 3737 3775 1240 159 
4 7 1844 780 3840 424 3709 1557 3628 
1 5 1836 2528 3743 3794 972 
1 11 402 2986 1741 2302 2978 2969 2971 2972 814 17 550 
1 4 2971 2972 814 437 
4 45 4904 2688 2632 4916 4920 4925 4927 2306 4928 1085 4932 2632 359 2087 4898 84 225 3 1015 174 1480 958 407 1307 4942 4949 4956 4959 1469 4955 4948 1480 543 2675 1353 4910 3 4873 4861 65 408 2043 660 1406 1484 
1 20 4904 4898 2087 1015 4910 1353 79 2587 1943 4922 813 4910 3 4873 1400 408 65 4861 3 225 
4 32 84 225 865 834 1014 4823 2436 613 4788 962 2380 1047 4759 4769 202 4760 4752 136 1590 1134 5 545 171 2037 1267 629 1163 2490 4637 260 1819 4628 
1 3 4959 4967 1469 
5 17 4935 4939 4946 4951 2245 4962 4966 4967 1469 4965 1272 4970 1070 774 1685 2587 1484 
4 12 834 624 27 1032 2464 1857 4776 2096 1378 4768 4761 4752 
2 45 544 4713 1576 730 1736 4738 1362 4728 4730 4740 698 211 1804 4754 25 4747 936 1680 4745 1804 238 4801 4811 1080 4837 4844 392 4865 4875 2592 4885 1091 1720 435 4859 848 4841 1252 699 4810 899 1051 4789 2001 2138 
1 10 1544 1588 724 1914 2282 4660 1296 264 490 4620 
3 14 629 1756 1197 2158 198 1578 1053 2308 1208 4683 278 2305 897 724 
3 34 2140 2239 1544 1588 2239 2140 2239 897 2305 2385 4712 94 4735 2060 4756 4762 2546 2725 2669 1612 4796 4805 4809 4820 4832 4825 4817 4807 4798 4787 1093 4766 2471 1186 
1 2 1186 2140 
3 16 4703 4700 4694 1029 861 1519 1251 4670 4665 662 331 4650 1108 985 4618 239 
3 13 1251 4664 266 4648 4641 757 1993 1284 4618 239 2646 636 2581 
1 9 743 6443 6285 6400 559 880 6387 6388 6392 
1 5 6447 6445 6444 6390 6387 
1 10 6392 6393 20 6395 2933 2932 1751 2934 365 1711 
1 9 1711 6406 6405 6404 2948 6412 6417 2952 2955 
1 11 1685 4980 1776 1631 1151 318 305 648 177 267 1706 
1 4 1706 265 520 5006 
1 16 1484 172 1585 4909 4908 1906 4899 4897 4889 2735 4892 2162 4903 4907 531 4923 
1 6 172 4954 253 4945 4953 1450 
1 11 4923 447 4902 4887 4878 1509 369 1464 1009 4785 4781 
1 2 1047 1443 
1 10 305 2148 240 1425 1074 903 96 2543 4990 919 
4 9 289 2432 2283 3552 518 3619 3674 1839 439 
3 5 518 567 3568 1359 3618 
4 8 1820 4329 4297 826 1750 226 4267 1356 
3 6 826 4302 4327 83 6287 4362 
3 7 6297 2006 1227 1007 24 4377 2574 
3 7 2574 376 4369 6291 4359 1878 1820 
3 8 1971 1333 2631 71 4479 250 4451 73 
2 7 4451 4457 474 2057 1891 4487 4486 
1 6 474 4475 595 354 180 1441 
3 7 1891 2078 2403 165 2617 4586 1465 
1 12 385 200 1198 4547 2494 2065 4504 4495 4490 1683 1011 1441 
1 8 385 4441 314 470 443 1275 1086 959 
3 12 2728 1017 1610 4879 4896 4912 4921 1195 4917 4913 822 823 
3 5 4816 4792 966 4835 2728 
3 5 2728 4858 1626 129 4879 
3 6 1626 1641 4860 4866 392 4844 
3 6 4860 4852 2242 4821 4812 4801 
3 6 4896 2266 1016 4872 2229 1145 
3 16 6 2053 2630 1555 2236 3112 3135 3163 3185 3175 481 3189 3156 1407 3134 1329 
3 7 1570 2987 908 1555 2236 1270 481 
3 4 750 2694 1642 3134 
1 6 3189 879 1847 3357 3288 3270 
1 4 3270 2507 2547 2032 
1 4 3110 3093 3087 3080 
1 2 3138 3129 
1 5 3138 691 1343 2612 3110 
1 3 3080 1784 3058 
1 6 1287 3114 3123 2356 3115 389 
1 7 2356 599 3133 3149 979 905 1670 
1 4 599 2427 484 3188 
1 7 2401 561 3150 1461 1624 2478 735 
1 11 735 1044 3265 2642 3298 3321 3336 2410 3347 2396 2571 
1 7 2536 6370 6369 6377 213 6374 2957 
1 7 213 6361 6368 6367 619 6366 2954 
1 8 2954 6372 2061 2949 2943 106 341 2135 
1 5 2949 2155 452 1341 630 
1 10 2959 90 2963 1833 2962 283 1772 1257 1568 1177 
1 6 2976 1746 2370 2099 2272 2993 
1 6 81 1603 391 1430 3012 463 
1 4 3011 1676 2998 1787 
3 14 1971 250 4479 4486 204 1940 4533 4540 2039 4562 1635 4602 4628 1819 
3 24 2085 867 1534 1990 1513 2902 515 2885 1868 2865 2558 2337 846 2834 2825 2589 350 1880 555 949 501 89 405 1537 
1 22 647 1654 2100 507 2186 672 1984 2734 1702 1031 77 288 2121 1607 2833 2835 2839 2844 320 2151 1447 846 
5 9 1868 2521 2882 2886 1467 797 2873 1947 2865 
1 10 555 135 2779 2777 2770 2763 2761 2752 2744 1786 
1 15 2865 2503 326 618 2570 1611 2826 1541 2817 1805 2814 195 539 2097 1963 
1 13 1684 228 1412 2058 2601 2895 1671 163 1099 587 568 2917 867 
1 9 6306 6307 6313 6301 6302 6304 2484 273 1230 
1 5 6307 6310 6311 6309 2828 
3 30 273 6316 6317 6318 6330 6322 6323 6320 687 6332 2176 6333 6325 6335 6338 6337 6341 6339 2857 6342 6343 6344 2872 2871 6348 2867 6347 2874 844 2877 
1 4 6356 6358 6350 2877 
1 7 638 2894 1237 2897 1454 2899 799 
1 4 2894 547 2878 2884 
1 4 638 895 2898 2267 
1 3 2914 1154 2913 
1 5 2914 2919 2912 1978 731 
1 3 2914 2908 2910 
5 47 1819 2709 4686 4692 1652 4695 733 4701 577 874 55 2011 1794 1455 2027 149 4891 4911 649 4930 1595 1518 4952 4940 4957 4964 203 652 654 1190 2111 4995 837 1530 5005 1838 413 1616 1886 914 5020 150 1514 571 2422 5034 5033 
1 4 3670 3655 2495 3679 
1 18 1861 2095 109 2455 935 6479 4642 1800 935 2213 1851 2710 614 1486 1245 839 2480 98 
4 12 1851 4622 858 4566 4554 2649 310 863 1242 1738 1452 1558 
1 4 98 2372 4773 1925 
2 4 241 1159 1021 3987 
1 5 2682 831 6283 6281 164 
1 8 1793 1869 1153 110 4134 4147 1457 4160 
2 7 4511 4484 2009 4466 302 6275 212 
3 5 4299 1498 1553 1975 4361 
1 6 4361 2311 1521 1072 470 2722 
1 10 385 1569 517 336 4391 582 2112 4349 1337 1309 
3 3 2649 445 4566 
