1 5 963 46 3523 3542 2569 
1 5 1309 2225 2114 2397 4205 
1 4 4205 4235 1211 4299 
1 5 4230 4258 4263 4279 4300 
1 3 4300 1813 2029 
1 2 4658 6262 
1 4 6262 6261 6268 6269 
1 5 4652 6268 6269 1180 2179 
1 3 6269 4636 2217 
1 3 4639 6274 2217 
1 3 4652 6267 4639 
1 3 4636 4625 4634 
1 2 6269 4643 
1 3 2179 6260 6259 
1 2 6259 1861 
1 3 4625 600 605 
1 4 605 185 2594 192 
1 3 192 8 1215 
1 5 1215 817 4545 4549 761 
1 2 761 815 
1 3 4605 182 4589 
1 3 2344 2531 4605 
1 4 2344 4570 609 2268 
1 2 2268 4511 
1 3 4624 4612 4589 
1 4 4619 1082 597 4624 
1 3 4631 1082 4619 
1 3 4627 4616 4619 
1 3 1024 4633 4627 
1 4 1024 4647 4649 4658 
1 2 4619 4609 
1 3 4609 4606 2451 
1 4 2047 872 850 4593 
1 4 2548 4622 31 4593 
1 4 2548 1743 4603 4595 
1 9 4595 4603 2251 2548 4622 363 2167 1800 1581 
1 4 4617 4615 4600 1581 
1 3 1581 2216 1038 
1 3 1038 6256 4601 
1 4 4565 4581 6256 4601 
1 3 4608 1185 4601 
1 4 4608 1508 4594 605 
1 4 4594 681 4576 409 
1 5 2161 2044 4731 4720 98 
1 3 1861 2095 109 
1 3 109 601 1245 
1 6 1841 4792 4816 2331 248 2434 
1 6 1841 4780 1477 4770 4777 4782 
1 4 2434 702 4829 2444 
1 2 4847 2444 
1 10 2444 2663 4824 4814 4804 2398 4793 2194 1925 4794 
1 4 4816 1824 4827 4840 
1 4 2434 4772 1118 4744 
1 6 4624 4611 294 4573 761 815 
1 6 4605 182 4572 565 4527 815 
1 5 6271 4612 294 2622 1215 
1 6 4594 2004 765 4546 4539 1371 
1 3 1371 1292 1681 
1 16 1215 194 1417 642 328 847 708 214 4438 2544 1936 4420 2706 4438 4422 1936 
1 4 2544 2706 516 2258 
1 9 2544 2706 4440 63 1335 4437 231 692 1733 
1 3 4484 1004 121 
1 14 815 444 4482 121 792 2240 1253 12 212 2717 190 4339 6273 4365 
1 5 4365 6273 553 4315 768 
1 3 768 4290 1398 
1 9 2240 1253 4385 2443 1653 2146 680 75 1717 
1 9 1717 4209 4160 330 941 2103 1236 3951 1844 
1 52 1398 4270 4266 4244 820 4219 1366 4188 1793 4145 6282 6279 1222 4009 3987 3959 2687 3894 3885 275 3875 957 3857 3795 2352 770 2390 1255 1475 1240 159 667 3907 2682 181 39 4030 2108 4090 1457 4147 4134 110 4177 4212 1826 4227 488 1869 460 164 241 
1 5 1844 3737 3775 1240 159 
1 7 1844 780 3840 424 3709 1557 3628 
1 5 1836 2528 3743 3794 972 
